Time, Free, Bound,State0,pY_SH2 binding_1,pY_SH2_binding_2,
0.0,20,0,20,0,0,
0.0040000099999842244,15,5,20,3,2,
0.00800000999996047,13,7,20,4,3,
0.012000009999936714,14,6,20,4,2,
0.016000009999978013,12,8,20,5,3,
0.020000000000648145,11,9,20,6,3,
0.02400000000131828,11,9,20,6,3,
0.028000000001988413,11,9,20,6,3,
0.03200000000265855,11,9,20,5,4,
0.03600000000332868,9,11,20,7,4,
0.040000000003998816,9,11,20,7,4,
0.04400000000466895,8,12,20,7,5,
0.048000000005339084,7,13,20,7,6,
