Time, Free, Bound,State0,pY_SH2 binding_1,pY_SH2_binding_2,
0.0,20,0,20,0,0,
0.0040000099999842244,18,2,20,1,1,
0.00800000999996047,16,4,20,3,1,
0.012000009999936714,13,7,20,5,2,
0.016000009999978013,13,7,20,5,2,
0.020000000000648145,13,7,20,5,2,
0.02400000000131828,11,9,20,5,4,
0.028000000001988413,8,12,20,6,6,
0.03200000000265855,8,12,20,7,5,
0.03600000000332868,7,13,20,9,4,
0.040000000003998816,7,13,20,10,3,
0.04400000000466895,9,11,20,7,4,
0.048000000005339084,8,12,20,8,4,
